XXXXXXXXXXXXXXX
X             X 
Xs x   p   x sX
X             X
XXXXXXXXXXXXXXX