XXXXXXXXXXXXXXXXXXXXXXXXXXXXXXXXXXXXX
X ss X           xbx           X ss X
Xs   X           xxx           X   sX
Xs   X                         X   sX
X                              X    X
XXXX X            m            X XXXX
X                                   X
X                                   X
X                                   X
X                                   X
X   p   XXXXXXXXXXdXXXXXXXXXX   p   X
X                                   X
X                                   X
X                                   X
X                                   X
XXXX X            m            X XXXX
X                                   X
Xs   X                         X   sX
Xs   X           xxx           X   sX
X ss X           xbx           X ss X
XXXXXXXXXXXXXXXXXXXXXXXXXXXXXXXXXXXXX